场景出现在什么积分段的组别,加载的场景序号
1青铜2白银3黄金4白金5钻石6王者,对应Stage表中的ID
Level,Num
index,json
1,[300000+300001+300002+300003+300004+300005+300006]
2,[300000+300001+300002+300003+300004+300005+300006]
3,[300000+300001+300002+300003+300004+300005+300006]
4,[300000+300001+300002+300003+300004+300005+300006]
5,[300000+300001+300002+300003+300004+300005+300006]
6,[300000+300001+300002+300003+300004+300005+300006]
